{
  "tileMap": [
    3, 1, 1, 5, 1, 1, 6, 1, 1, 5, 1, 11, 12, 13, 1, 1, 1, 1, 6, 1, 1, 19, 20,
    21, 1, 3, 1, 1, 1, 1, 1, 27, 28, 29, 1, 1, 11, 12, 13, 6, 6, 1, 3, 1, 6, 1,
    19, 20, 21, 1, 1, 1, 1, 5, 1, 1, 27, 28, 29, 1, 3, 1, 14, 1, 1, 1, 1, 1, 1,
    1, 6, 1, 14, 14, 14, 3, 1, 6, 14, 14, 1, 1, 1, 1, 14, 1, 1, 1, 1, 1, 1, 1,
    3, 1, 1, 5, 1, 1, 6, 1, 1, 1, 5, 1, 6, 3, 1, 1, 3, 6, 3, 6, 1, 1, 1, 6, 1,
    5, 5, 1, 1, 1, 1, 5, 1, 1, 1, 1, 1, 1, 1, 3, 1, 3, 1, 1, 14, 14, 5, 1, 1,
    11, 12, 13, 1, 1, 14, 14, 14, 1, 1, 19, 20, 21, 5, 1, 1, 14, 1, 3, 1, 27,
    28, 29, 1, 3, 1, 5, 1, 1, 1, 5, 1, 1, 1, 1, 1, 6, 3, 1, 5, 3, 1, 3, 6, 1, 3,
    1, 3, 5, 1, 1, 1, 5, 3, 6, 1, 1, 5, 1
  ]
}
